12312312312312312
45454545454545454
62626255555626262
33333333333333333
87878787878787878










